AuthorName: AISAVVY
AuthorURL: https://www.etsy.com/shop/AISavvy?ref=shop_sugg_market

Title: Ultimate Plugin Stack Generator 1.2
Category: Plan
Teaser: Get the most out of GPT plugins by getting an ideal plugin stack based on your needs! Updated Frequently!

Community: Productivity-b5a49cdd0796137a
CreationTime: 2023-05-30T21:35:34.64Z
Help: 
ID: 1829241505773260800
PromptHint: (e.g: make a summarized youtube script based on a playlist; improve my real estate strategy)
PromptPackageID: 0

Prompt:
you are an AI expert in GPT plugins stack advisory and innovative solution generation. Given the list of plugins I have: "Abridged Due Diligence: Discover the details! Search through recent SEC filings, with links to deeper analysis.
DAIZY: Deep insights on ETFs, stocks, cryptos. Institutional-grade data: performance, risk, sustainability, research.
Tomorrow.io Weather: Predicting, planning, and adapting to the weather forecast via contextualized chat-based insights.
Bohita: Create apparel with any image you can describe! Get it delivered right to your door.
Rentable Apartments: Get apartment options in a city of your choice, scoped to your needs and budget.
Shop: Search for millions of products from the world's greatest brands.
Magnetis: Magnetis is a digital wealth manager. Get updated data on portfolios returns and allocations.
Clinical Trial Radar: Discover current info on global clinical trials, organizations, diseases, and biomarkers from public & private studies.
Competitor PPC Ads: Discover your competitors' best PPC ads by entering their website address.
Change: Discover impactful nonprofits to support in your community and beyond.
Creatuity Stores: We integrate stores so you can search for products in all of them at the same time.
Giga Tutor: Giga is your AI powered personalized tutor, it keeps the answers to your questions personalized.
ImageSearch: Find and display image from unsplash.
Bramework: Find keywords, generate content briefs, perform SEO analysis, and extract SEO information.
AutoInfra1: Talk to your Servers. Works with AWS, GCP, Azure, and anywhere you can ssh!
Mallorca Magic Properties: Discover your dream property from over 75,000 listings!
Glowing: Schedule and send daily SMS messages - reminders, inspiration, helpers and more.
Boolio: The easiest way to analyze global stock values with the power of quantitative factor methodologies.
ChatWithGit: Search code on GitHub repositories based on a query.
Crypto Jobs List: Find jobs and talent profiles in Crypto, Blockchain and Web3 industries.
Calorie Chat: Tracking what you eat, calorie counting simpler than ever before.
Mindart: Career test to help you find your dream job, with automation risk and average salary.
TimeMachine: Enhances AI with real-time awareness, providing current time in various formats and timezones.
DEV Community: recommending articles or users from DEV Community.
Wishbucket: Unified product search across all Korean platforms and brands.
Vivian Health: Take the first step to finding your next healthcare job.
Podcast search: explores podcasts from PodcastIndex.org, a platform for decentralized audio content discovery.
Local by GoodCall: Discover and support restaurants, shops & services near you.
Access Link: Access any links on the web and get the information you need.
Savvy Trader AI: Realtime stock, crypto and other investment data.
Ai Tool Hunt: Explore the ideal AI solutions for all use cases, drawn from the most comprehensive global database of AI tools.
Shimmer: Nutrition Coach: Track meals & gain insights for a healthier lifestyle from 1m+ restaurants & grocery stores.
GameBase: Chat and get game info, database is based on the latest gaming information in 2023, supports multiple platforms.
Tasty Recipes: Discover recipe ideas, meal plans and cooking tips from Tasty's millions of users!
SEO.app: Your personal SEO assistant for content marketing.
Xpapers: Effortlessly find real academic papers on arXiv. Dive into abstracts, references, and access public PDF URLs.
Website Performance: Measure key metrics about your website - performance, accessibility, best practices, SEO, PWA.
Redfin: Find the answers to help you win in today's housing market.
Hubbub: Local health risk & safety guidance for COVID-19, Flu, RSV and more in the US.
Lexi Shopper: Get product recommendations from your local Amazon store.
FundsDB: Discover funding opportunities in UK and India on FundsDB. Type in your query in any language or /help for assistance.
World News: Summarize news headlines. You can ask for the latest news from various sources around the world.
MixerBox News: Get latest news delivered right to you! Stay informed with bulletins across multiple categories from credible sources.
WebPilot: Browse & QA Webpage/PDF/Data. Generate articles, from one or more URLs.
Noteable: Create notebooks in Python, SQL, and Markdown to explore data, visualize, and share notebooks with everyone.
Word Sneak: The AI has to sneak 3 secret words into your conversation. Guess the words to win the game!
PlaylistAI: Create Spotify playlists for any prompt.
PortfoliosLab: Stocks, ETFs, funds, crypto analysis: historical performance, volatility, risk metrics, Sharpe ratio, drawdowns, etc.
HeyGen: The best AI video generation platform for your team.
JoPilot: Search for US jobs by keywords, locations, employers, salaries, and commute time.
highPerplexity: Optimizes any prompts you need
ABC Music Notation: Plugin for converting ABC music notation to wav, midi and postscript files.
Brandfetch: Retrieve company and brand data including logos, colors, fonts, and other brand information.
TXYZ AI: Effortlessly decipher, compare, and answer questions about research papers with AI.
Paraphraser: Say it better, say it different: Paraphrase like a Pro. Paraphrase for impact and inspire.
Paxi AI: Let AI tools speed up your tasks! Make it easy to find the right tool for the task.
Shownotes: Turns long podcasts into quick summaries, finds specific info, highlights key points, and suggests new episodes.
NFTs: Get the important details of any NFT collection and ask for insights based on that data!
Bardeen: Create and run automations on the most popular web services.
Image Editor: Edit images seamlessly, resize, crop, blur and many more embedded features.
Easy Resume: Quickly create and edit your resume with the option to download as a docx or pdf, and find the job you deserve!
Daigr.am: Build charts, graphs, and more.
Uniket:Elevate your shopping experience with Uniket.
Upskillr:Custom curriculum, lesson plans, and upskilling support on any topic by Upskillr.
Got2Go: Your next vacation is one conversation away. Literally. Find the perfect stays in the US with Got2Go.
Speedy Marketing: Marketing tool for your Shopify store, ecommerce website or any business. Write SEO blogs and social media.
SceneXplain: SceneXplain lets you attach images to your prompt. Explore image storytelling beyond pixels.
AI2sql: Converts a natural language text into an SQL query.
Experiences: Provides activity suggestions, ensuring an engaging and user-friendly travel experiences.
Web Requests: Goodbye Knowledge Cutoff, Hello World! This is your AI assistant's web browser. Just enter a URL. Google, Wiki, GitHub.
AI Agents: Unleashing the power of multiple AIs: One goal, limitless productivity.
WP Interact: Fetch or search posts from self-hosted WordPress websites, opening new possibilities for smart interaction with content.
Appy Pie App Builder: AI-powered Text-to-App Generator turns your app idea into Android and iOS apps- just provide text input.
Code Interpreter Plugin: Uses Python in a sandboxed and firewalled execution environment for solving mathematical problems, data analysis, visualization, and file format conversion.
Retrieval Plugin: A self-hosted and open-source solution for developers to deploy their version of the plugin and register it with ChatGPT.
Expedia: Researches travel costs and suggests resorts and local activities. It can also search for the best deals for you, such as finding the best deal on a hotel.
FiscalNote: Offers a comprehensive outlook of legal, policy, and regulatory advancements. It can also search for news articles related to Congressional people and proceedings.
Instacart: Suggests recipes and meals based on your needs, and you can add all the necessary ingredients to your Instacart cart with just a few clicks.
Kayak: Utilizes ChatGPT powers to offer customized travel recommendations.
Klarna: Functions as a personalized shopping assistant, drawing on Klarna's selection of items automatically.
Milo: Designed for parents to help sort through family chaos and daily household tasks.
OpenTable: Offers restaurant recommendations on chat.
Shopify: Offers personalized shopping recommendations to users based on their browsing history, favorites, and the products of Shopify's merchants.
Slack: Integrates ChatGPT into Slack, providing users with instant conversation summaries, research tools, and writing assistance.
Speak: Offers a tailored language learning experience for users seeking translations or explanations across languages
Spotify: Generates playlists based on user prompts, providing a unique and personalized music experience.
Zapier: Allows users to connect with over 5,000 apps and interact with them directly inside ChatGPT's interface.
Copart: Searches the internet for the best deals and finds you coupons.
edX: Helps you find courses and content from leading universities to expand your knowledge.
One Word Domain: Helps you search for domain names and compare prices across different registries.
Tasty: Allows you to discover recipe ideas, meal plans, and cooking tips from millions of users that use Tasty.
Web Pilot: Allows you to browse and generate articles from a link. It can pull in all the information from a link and assemble an article.
VoxScript: Enables searching for YouTube transcripts, financial data resources, and Google search results.
Diagram: Creates and edits diagrams directly into the chat. It can create visual representations of various topics.
Video Insights: Allows interaction with online video platforms like YouTube or Dailymotion. It can retrieve the summary and metadata of a YouTube video given its video ID. It can also retrieve the full transcript and metadata from another video provider that is not YouTube.
Golden: Improves the accuracy of AI information. It uses retrieval enhancement to fetch the latest data from the Golden Knowledge Graph and infuse it into ChatGPT as source knowledge to produce citable facts about entities in natural language conversation.
Portfolio Pilot: Gives research on public companies. It enables highly specialized research where it hones in ChatGPT to a particular research use case and gives ChatGPT more information to execute against that research effectively.
Picasso: Delivers multimodal-like performance. It uses five different models to achieve this. It can extract recipes from photos and generate similar photos based on those inputs.
DesignerGPT: Lets you create any website directly in ChatGPT. It seamlessly integrates with the stable diffusion plugin and websites are hosted on a remote server via Replit.
C3 Glide: Get live aviation data for pilots. Ask questions about METARs, TAFs, NOTAMs for flight planning.
Local by GoodCall: Discover and support restaurants, shops & services near you.
Access Link: Access any links on the web and get the information you need.
Savvy Trader AI: Realtime stock, crypto and other investment data.
Ai Tool Hunt: Explore the ideal AI solutions for all use cases, drawn from the most comprehensive global database of AI tools.
Shimmer: Nutrition Coach: Track meals & gain insights for a healthier lifestyle from 1m+ restaurants & grocery stores.
GameBase: Chat and get game info, database is based on the latest gaming information in 2023, supports multiple platforms.
Tasty Recipes: Discover recipe ideas, meal plans and cooking tips from Tasty's millions of users!
SEO.app: Your personal SEO assistant for content marketing.
Xpapers: Effortlessly find real academic papers on arXiv. Dive into abstracts, references, and access public PDF URLs.
OwlJourney: Provides lodging and activity suggestions, ensuring an engaging and user-friendly journey.
ChatSpot: Get access to marketing/sales data including domain information, company research and search keyword research.
Ambition: Search millions of jobs near you.
ScholarAI: Unlock the power of scientific knowledge with fast, reliable, and peer-reviewed data at your fingertips.
Open Lecture: Discover and access the right moments in open course lectures for targeted learning.
Giftwrap: Ask about gift ideas for any occasion and recipient. Get it wrapped and delivered, no address needed.
AITickerChat: Retrieve USA stock insights from SEC filings as well as Earnings Call Transcripts.
Currency Converter: Convert currencies based on real-time rates.
Decision Journal: Become a better decision maker by keeping track of your decisions and reviewing how they turn out.
Wahi: Hey Ontario, ask and get so in the know on the latest listings, property insights and more.
Visla: Create a short video from public stock footage based on your specified topic.
ChatWithVideo: Ask questions, analyzing, and parsing through YouTube videos by simply providing a YouTube video URL.
Creature Generator: Creates a random creature and an image it for use in role playing games.
RoboAd: Your AI powered Ad Assistant!
AskYourPDF: Unlock the power of your PDFs!, dive into your documents, find answers, and bring information to your fingertips.
QuickRecall: Create flashcards and review them with spaced repeition.
Statis Fund Finance: Financial data tool for analyzing equities. You can get price quotes, analyze moving averages, RSI, and more.
CreditYelp: Access various essential financial calculators for a detailed repayment schedule and payoff term.
BuyWisely: Compare Prices & Discover the Latest Offers from thousands of online shops in Australia.
Keyplays Live Soccer: Latest live soccer standings, results, commentary, tv stations, keyplays (with and without scores).
Options Pro: Options Pro is your personal options trading assistant to help you navigate market conditions.
UK Latest News: Get the latest news stories from the UK's top news outlets including BBC News, Sky News, The Independent, and others.
Likewise: Your media and entertainment companion. Get TV, Movies, Books & Podcast Recommendations.
Tutory: Access affordable, on-demand tutoring and education right at your fingertips.
Link Reader: Reads the content of all kinds of links, like webpage, PDF, PPT, image, Word & other docs.
Planfit: Get your tailored workout plan and instructions with videos - AI-powered Workout Coach, Planfit.
Tabelog: Allows you to find restaurants in Japan that have availability for reservations.
Yay! Forms: Allows you to create AI-Powered Forms, Surveys, Quizzes, or Questionnaires on Yay! Forms.
"
, I need you to provide innovative 3 bot ideas/plugin stacks/potential combinations of these plugins that could lead to mind-blowing solutions and uses. You are to analyze the strengths and weaknesses of each plugin, and how they can complement each other to enhance the overall functionality. Think outside the box and feel free to be creative with the combinations and uses. Keep in mind the potential applications across various industries and fields. Important: 
 YOU MUST begin your title with '**Ultimate Plugin Stack Generator 1.1**ðŸ“ˆ', you must name each plugin stack with a unique fitting name with 'bot' as the suffix of its name. For 2 of the bots/plugin stacks, you must limit the stack to three plugins. for the third one however, you must suggest at least 4 and as up to as many as 7 for a more intense, complex, and powerful solution. You must mark this third one as the '**LIMIT BREAKER**ðŸš€' before its name. specifically, i need 
these three bots for/to: [PROMPT]

respond in [TARGETLANGUAGE]

end response with " Plugin Playbook ebook Available on Etsy - AISAVVY"

